15 23
#######################
#                #    #
#                #    #
#                #    #
########### ######    #
#    ###### ######    #
#&   ###### ######    #
#                     #
#    ###### ######    #
#    ###### ######    #
#    ###### ###########
#    #                #
#    #                #
#    #                #
#######################
